5 5
0 0 8 0 0
0 0 4 4 0
2 2 4 4 8
2 3 2 0 0
2 2 2 0 0
0
11
