6 5
0 0 2 0 0
0 0 1 1 2
0 0 1 0 0
7 1 6 7 0
0 1 0 0 0
0 2 0 0 0
4
0 2 D
1 2 U
1 4 R
5 1 D
8
