6 6 
0 0 7 0 0 0 
0 0 7 0 2 0 
1 1 2 1 1 7
1 0 2 0 0 0 
2 0 1 0 0 0 
6 0 1 0 0 0 
3
2 0 L
2 4 U
1 4 D
9