6 5
0 0 6 1 6
0 0 0 0 0
0 0 5 0 0
2 1 1 0 2
2 1 5 0 0
2 1 1 0 0
0
8
