6 5
0 0 8 0 0
0 0 6 0 0
0 0 2 0 0
0 0 1 1 5
7 1 2 2 1
0 0 2 0 0
0
8
