5 6
0 0 0 2 2 0
0 0 2 3 8 0
0 0 5 1 1 2
0 0 0 0 0 0
6 0 7 2 1 0
0
10