5 5
0 0 1 5 5
0 0 2 1 0
5 1 1 1 0
0 1 1 1 0
2 2 5 2 0
0
9
