5 5
0 0 0 0 2
0 0 0 0 2
5 1 5 0 2
1 1 1 2 2
6 1 5 0 4
0
13
