6 6
0 0 0 0 7 0
0 0 0 0 6 0
0 0 0 0 1 0
2 1 4 7 1 0
2 0 1 0 1 2
2 0 0 0 0 0
4
3 0 L
4 5 L
4 4 R
5 0 D
10