7 5
0 7 0 0 0
0 7 0 0 0
1 7 1 1 8
0 1 0 0 0
0 2 0 0 0
1 1 2 0 0
2 1 2 0 0
4
5 0 L
5 2 R
6 2 R
6 1 D
8