5 7
0 0 0 0 2 0 0
7 7 7 2 8 2 1
0 0 0 0 3 0 1
0 0 0 0 0 0 1
0 0 0 0 0 1 1
2
1 6 R
4 6 D
10