5 7
0 1 2 1 1 7 0
0 1 0 2 0 1 0
8 1 0 6 0 1 2
0 1 0 0 0 1 0
0 7 1 1 2 1 0
5
2 3 L
2 3 R
2 3 U
2 3 D
1 3 D
12