6 6
0 2 0 0 0 0
0 0 0 0 0 0
2 1 1 5 1 1
0 1 0 0 0 0
0 2 1 6 0 0
0 0 8 0 0 0
2
2 0 R
2 1 L
10
