7 7 
0 0 0 7 0 0 0
0 0 0 1 0 0 0
0 0 0 2 0 0 0
8 6 2 2 2 2 7
0 0 0 2 0 0 0
0 0 0 5 0 0 0
0 0 0 4 0 0 0
0 
7