5 5
0 0 2 0 0
7 0 2 0 0
6 0 5 1 1
2 0 0 0 0
6 1 1 2 0
0
6