5 5
7 0 0 0 2
1 0 0 0 1
1 1 1 2 1
1 1 1 0 0
0 0 5 0 0
1
4 2 D
11