6 6
0 0 7 0 0 0
0 0 1 0 0 0
0 0 2 0 0 0
2 6 1 1 1 2
0 0 0 0 1 0
0 0 0 0 5 0
4
3 1 R
3 2 L
3 2 R
3 3 L
7