6 5
0 0 5 1 5
1 1 1 0 5
2 2 1 0 1
1 1 1 1 1
0 0 1 0 0
0 0 2 0 0
4
1 1 D
2 1 U
2 2 D
3 2 U
11