5 5
0 0 1 2 2
0 0 4 3 2
6 0 1 2 2
0 0 0 0 0
6 0 6 0 0
0
8
