5 5 
0 0 0 2 0
0 0 0 6 0
0 0 0 1 0
6 1 3 1 2
0 0 0 2 0
2
2 3 D
3 3 U
5
