5 5
8 0 1 1 2
0 0 3 8 2
0 0 0 0 0
2 0 0 0 0
8 0 0 2 0
0
8
