5 5
0 2 0 2 0
0 1 1 2 0
1 5 1 1 2
5 5 1 0 0
5 0 0 0 0
2
1 2 D
2 2 U
10