5 5
0 1 5 1 6
0 0 2 0 0
0 1 2 2 0
0 2 1 1 0
7 5 1 1 0
4
3 1 R
3 2 L
3 2 R
3 3 L
9