5 5
0 0 1 0 2
0 0 0 0 0
0 0 1 0 0
2 0 1 0 6
6 0 1 0 0
0
6