6 6
0 0 1 1 1 7
0 0 1 1 0 0
0 0 1 1 0 2
0 0 0 1 0 0
5 1 1 2 2 8
0 0 1 0 0 0
3
0 2 L
1 3 R
4 3 D
11
