5 5
0 0 2 0 0
0 0 0 0 0
0 1 2 2 5
0 1 0 0 0
1 5 1 6 0
0
7
